11111111111111111111111111111111111111
1CCCCCCCCCCCCCCCCCCCCCCCCCCCCCCCCCC0E1
1C111111110000000000011111111111111101
1C1111111100000000000111111111111111C1
1C1111111100000000000111111111111111C1
1C1100001100000000000000000000001111C1
1C11000011000000000000000000G0001111C1
1C0000001100000000000000000000001111C1
1C0000001100000000000000000000001111C1
1C0000001100G00000000011000000001111C1
1C000000110000000000001111111111111GC1
1C0000001100000000000011111111001111C1
1C00G0P01100000000000000000000001111C1
1C00000011000000000000000000G0001111C1
1C0000001100000000000000000000001111C1
1C0000001100000000000000000000001111C1
1C00011111111000G0000111111111111111C1
1C0001111111100000000111111111111111C1
1C0001111111100000000111111111111111C1
1CCCCCCCCCCCCCCCCCCCCCCCCCCCCCCCCCCCC1
11111111111111111111111111111111111111