1111111111111111111111111111111111
1000000000000000000000000000000001
1000000000000000000000000000000001
1000000000000000000000000000000001
1000000000000000000000000000000001
1000000000000C00000000000000001001
1000000000000000000000000000000001
10000000000000000000000000C0000001
1000000000G00000000000000G00000001
10000000P0000000000000000000000001
1000000000000000000000000000000001
1000000000000000000000000000000001
10000000000000000E0000000000000001
1000000000000000000000000000000001
100000000000G000000000000000000001
1000000000000000000000000000000001
1000000000000000000000000000000001
1000000000000000000000000000000001
1000000000000000000000000000000001
1111111111111111111111111111111111