1111111111111111111111111111111111111
1CCCCCCCCCCCCCCCCCCCCCCCCCCCCCCCCC0E1
1C11111111000000000001111111111111101
1C111111110000000000011111111111111C1
1C111111110000000000011111111111111C1
1C110000110000000000000000000001111C1
1C11000011000000000000000000M001111C1
1C000000110000000000000000000001111C1
1C000000110000000000000000000001111C1
1C000000110000000000001100000001111C1
1C000000110000000000001111111111110C1
1C000000110000000000001111111001111C1
1C0000P0110000000000000000000001111C1
1C000000110000000000000000000001111C1
1C000000110000000000000000000001111C1
1C000000110000000000000000000001111C1
1C000111111110000000011111111111111C1
1C000111111110000000011111111111111C1
1C000111111110000000011111111111111C1
1CCCCCCCCCCCCCCCCCCCCCCCCCCCCCCCCCCC1
1111111111111111111111111111111111111