1111111111111111111111111111111111111111
1CCCCCCCCCCCCCCCCCCCCCCCCCCCC1CCCCCCCCC1
1CCCCCCCCCCCCCCCCCCCCCCCCCCCCCCCCCECCCC1
1CCCCCCCCC111111111111111111111111111111
1CCCCCCCCCCCCCCCCCCCCCCCCCCCCCCCCCCCCCC1
1CCCC1111CCC111CCCC111CCC111CCC111CCCCC1
111111CCC111CCCC111CCC111CCC111CCC111CC1
1CCCCCCCCCCCCCCCCCCCCCCCCCCCCCCCCCCCCCC1
1C1CP1CC1CC1CC1CC1CC1CC1CC1CC1CC1CC1CC11
1111111111111111111111111111111111111111