111111111111111111111111111111111111111111
1CCCCCCCCCCCCCCCCCCCCCPCCCCCCCCECCCCCCCCC1
1C111C111111111C111111111111111C11111111C1
1C111C111111111C111111111111111C11111111C1
1CCCCC111111111CCCCCCCCCCCCCCCCCCCCCCCCCC1
11111C111CCCCCCC1111111C111111100000000001
111111111111111111111111111111111111111111