1111111111111111111111
100100000000100C001001
1000C0111110100C101001
1P001100CE0C00001000M1
1111111111111111111111