1111111111111
1C010000000C1
1000011111M01
1P001CC00E001
1111111111111