1111111111111111111111111111111111111111111111111111111111111111111111111111
1CCCCCCCCCCCCCCCCCCCCCCCCCCCCCCCCCCCC00CCCCCCCCCCCCCCCCCCCCCCCCCCCCCCCCCCCC1
1CCCCCCCCCCCC1111111C111111111111111C00CCCCCCCCCCCC1111111C111111111111111C1
1CCCCCCCCC11111111CCC1111CCC11111111C00CCCCCCCCC11111111CCC1111CCC11111111C1
1CCCCCCC1111111CCCCCC1C1MCCC11111111C00CCCCCCC1111111CCCCCC1C1MCCC11111111C1
1CCCC11111111CCCCCCCC1CCCCCC1111111CC00CCCC11111111CCCCCCCC1CCCCCC1111111CC1
1CC1110111CCCCCCCCCCCCCCC11111111CCCC00CC1110111CCCCCCCCCCCCCCC11111111CCCC1
1C111111CCCCCCCCCCCCCCC1111111CCCCCCC00C111111CCCCCCCCCCCCCCC1111111CCCCCCC1
1C1111CCCCCCC1CCCCCCC1111111CCCCCCCCC00C1111CCCCCCC1CCCCCCC1111111CCCCCCCCC1
1C111111111111111111C1111111CCCCC111C00C111111111111111111C1111111CCCCC111C1
1C111111111111111111C1111111CCC11111C00C111111111111111111C1111111CCC11111C1
1C111111111111111111C1111111C1111111C00C111111111111111111C1111111C1111111C1
1CCCCCCCCCCCC1111111CCCCCCCCCCCCCCCCC00CCCCCCCCCCCC1111111CCCCCCCCCCCCCCCCC1
1CCCCCCCCCCCC1111111C11CCCCCCCCCCCCCC00CCCCCCCCCCCC1111111C11CCCCCCCCCCCCCC1
1CCCCCCCCCCCC1111111C1111111111111CCC00CCCCCCCCCCCC1111111C1111111111111CCC1
1PCCCCCCCCCCC1111111CCCCCCCCCCCCCCCC0000CCCCCCCCCCC1111111CCCCCCCCCCCCCCCC01
1000000000000000000000000000000000000000000000000000000000000000000000000001
1000000000000000000000000000000000000000000000000000000000000000000000000001
1CCCCCCCCCCCCCCCCCCCCCCCCCCCCCCCCCCCC00CCCCCCCCCCCCCCCCCCCCCCCCCCCCCCCCCCCC1
1CCCCCCCCCCCC1111111C111111111111111C00CCCCCCCCCCCC1111111C111111111111111C1
1CCCCCCCCC11111111CCC1111CCC11111111C00CCCCCCCCC11111111CCC1111CCC11111111C1
1CCCCCCC1111111CCCCCC1C1MCCC11111111C00CCCCCCC1111111CCCCCC1C1MCCC11111111C1
1CCCC11111111CCCCCCCC1CCCCCC1111111CC00CCCC11111111CCCCCCCC1CCCCCC1111111CC1
1CC1110111CCCCCCCCCCCCCCC11111111CCCC00CC1110111CCCCCCCCCCCCCCC11111111CCCC1
1C111111CCCCCCCCCCCCCCC1111111CCCCCCC00C111111CCCCCCCCCCCCCCC1111111CCCCCCC1
1C1111CCCCCCC1CCCCCCC1111111CCCCCCCCC00C1111CCCCCCC1CCCCCCC1111111CCCCCCCCC1
1C111111111111111111C1111111CCCCC111C00C111111111111111111C1111111CCCCC111C1
1C111111111111111111C1111111CCC11111C00C111111111111111111C1111111CCC11111C1
1C111111111111111111C1111111C1111111C00C111111111111111111C1111111C1111111C1
1CCCCCCCCCCCC1111111CCCCCCCCCCCCCCCCC00CCCCCCCCCCCC1111111CCCCCCCCCCCCCCCCC1
1CCCCCCCCCCCC1111111C11CCCCCCCCCCCCCC00CCCCCCCCCCCC1111111C11CCCCCCCCCCCCCC1
1CCCCCCCCCCCC1111111C1111111111111CCC00CCCCCCCCCCCC1111111C1111111111111CCC1
10CCCCCCCCCCC1111111CCCCCCCCCCCCCCCC0000CCCCCCCCCCC1111111CCCCCCCCCCCCCCCCE1
1111111111111111111111111111111111111111111111111111111111111111111111111111